2 1 1 1 1 1 1 1 1 1 1 1 1 4 1 1 1 1 1 1
2 2 2 1 1 1 1 1 1 5 1 1 1 2 1 1 1 1 1 1
1 1 2 2 2 2 2 2 2 2 2 1 1 2 1 1 1 1 1 1
1 1 2 1 1 1 1 1 1 1 2 2 2 2 2 2 2 2 2 4
1 1 2 2 2 2 1 1 1 1 1 2 1 1 6 1 1 1 1 1
1 1 2 1 1 2 2 2 2 2 2 2 2 2 1 1 1 1 1 1
4 2 2 1 1 2 3 1 1 7 1 1 1 2 1 1 1 1 1 3
3 3 1 3 3 2 3 3 1 1 1 1 1 2 1 1 1 1 3 3
3 3 1 3 3 2 3 3 3 1 1 1 1 2 2 2 2 2 2 4
3 3 7 3 3 2 3 3 3 3 1 1 1 2 1 1 1 3 3 3
3 3 3 3 3 2 3 3 3 3 3 3 1 2 1 3 3 3 3 3
3 3 3 3 3 4 3 3 3 3 3 3 3 4 3 3 3 3 3 3
